"aa" = (/turf/map/grass,/area)
"ab" = (/turf/map/hill,/area)
"ac" = (/turf/map/river/end{dir = 8},/area)
"ad" = (/turf/map/tree/top,/area)
"ae" = (/turf/map/mountain/rocks{dir = 1},/area)
"af" = (/turf/map/tree/bottom{dir = 1},/area)
"ag" = (/turf/map/tree/top{dir = 1},/area)
"ah" = (/turf/map/tree/top{dir = 4},/area)
"ai" = (/turf/map/mountain/tip,/area)
"aj" = (/turf/map/mountain/rocks,/area)
"ak" = (/turf/map/tree/bottom,/area)
"al" = (/turf/map/hill/mountain,/area)
"am" = (/turf/map/mountain,/area)
"an" = (/turf/map/mountain/angle{dir = 1},/area)
"ao" = (/turf/map/structure/castle,/area)
"ap" = (/turf/map/dirt/angle{dir = 1},/area)
"aq" = (/turf/map/structure/small_house,/area)
"ar" = (/turf/map/tree,/area)
"as" = (/turf/map/light/angle{dir = 1},/area)
"at" = (/turf/map/dirt/angle{dir = 8},/area)
"au" = (/turf/map/dirt,/area)
"av" = (/turf/map/light/angle,/area)
"aw" = (/turf/map/light,/area)
"ax" = (/turf/map,/area)
"ay" = (/turf/map/dirt/angle{dir = 4},/area)
"az" = (/turf/map/structure/house{dir = 8},/area)
"aA" = (/turf/map/structure/house{dir = 4},/area)
"aB" = (/turf/map/light/angle{dir = 8},/area)
"aC" = (/turf/map/light/angle{dir = 4},/area)
"aD" = (/turf/map/structure/hamlet{dir = 1},/area)
"aE" = (/turf/map/structure/hamlet{dir = 8},/area)
"aF" = (/turf/map/structure/hamlet/east{dir = 1},/area)
"aG" = (/turf/map/structure/house{dir = 1},/area)
"aH" = (/turf/map/structure/house,/area)
"aI" = (/turf/map/mountain/base,/area)
"aJ" = (/turf/map/structure/hamlet,/area)
"aK" = (/turf/map/structure/hamlet{dir = 4},/area)
"aL" = (/turf/map/structure/hamlet/east,/area)
"aM" = (/turf/map/dirt/angle,/area)
"aN" = (/turf/map/mountain/angle/right{dir = 4},/area)
"aO" = (/turf/map/grass/end/base{dir = 8},/area)
"aP" = (/turf/map/dark,/area)
"aQ" = (/turf/map/dark/angle,/area)
"aR" = (/turf/map/tree/top{dir = 8},/area)
"aS" = (/turf/map/river,/area)
"aT" = (/turf/map/river/angle{dir = 1},/area)
"aU" = (/turf/map/river/end/curve,/area)
"aV" = (/turf/map/river/end,/area)
"aW" = (/turf/map/light/end{dir = 1},/area)
"aX" = (/turf/map/river/angle,/area)
"aY" = (/turf/map/mountain/base{dir = 8},/area)
"aZ" = (/turf/map/river/end{dir = 4},/area)
"ba" = (/turf/map/bridge{dir = 4},/area)
"bb" = (/turf/map/bridge,/area)
"bc" = (/turf/map/river/angle{dir = 8},/area)
"bd" = (/turf/map/river/end{dir = 1},/area)
"be" = (/turf/map/river/angle{dir = 4},/area)
"bf" = (/turf/map/mountain/base{dir = 4},/area)
"bg" = (/turf/map/mountain/top{dir = 1},/area)
"bh" = (/turf/map/river/end/grass{dir = 1},/area)
"bi" = (/turf/map/bridge/end{dir = 1},/area)
"bj" = (/turf/map/river/straight,/area)
"bk" = (/turf/map/river/end/grass,/area)
"bl" = (/turf/map/river/angle/small{dir = 1},/area)
"bm" = (/turf/map/river/curve{dir = 1},/area)
"bn" = (/turf/map/mountain/top,/area)
"bo" = (/turf/map/dark/angle{dir = 8},/area)
"bp" = (/turf/map/bridge/end,/area)
"bq" = (/turf/map/river/straight{dir = 4},/area)
"br" = (/turf/map/mountain/top{dir = 8},/area)
"bs" = (/turf/map/mountain/angle/right{dir = 1},/area)
"bt" = (/turf/map/river/curve{dir = 4},/area)
"bu" = (/turf/map/mountain/angle/left,/area)
"bv" = (/turf/map/river/curve{dir = 8},/area)
"bw" = (/turf/map/light/end{dir = 8},/area)
"bx" = (/turf/map/river/angle/small,/area)
"by" = (/turf/map/dark/curve{dir = 8},/area)
"bz" = (/turf/map/river/curve,/area)
"bA" = (/turf/map/river/end/grass{dir = 8},/area)
"bB" = (/turf/map/river/angle/small{dir = 4},/area)
"bC" = (/turf/map/grass/river/dark{dir = 4},/area)
"bD" = (/turf/map/river/angle/small{dir = 8},/area)
"bE" = (/turf/map/tree/bottom/two{dir = 1},/area)
"bF" = (/turf/map/bridge/end{dir = 8},/area)
"bG" = (/turf/map/bridge/end{dir = 4},/area)
"bH" = (/turf/map/grass/river/light{dir = 4},/area)

(1,1,1) = {"
aaaaaaaaaaaaaaaaaaaaaaaaaaaaaaaaaaaaaaaaaaaaaaaaaaaaaaaaaaaaaaaaaaaaaaaaaaaaaaaaaaaaaaaaaaaaaaaaaaaaaaaaaaaaaaaaaaaaaaaaaaaaaaaaaaaaaaaaaaaaaaaaaaaaaaaaaaaaaaaaaaaaaaaaaaaaaaaaaaaaaaaaaaaaaaaaaaaaaaaa
aaaaaaaaaaaaaaaaaaaaaaaaaaaaaaaaaaaaaaaaaaaaaaaaaaaaaaaaaaaaaaaaaaaaaaaaaaaaaaaaaaaaaaaaaaaaaaaaaaaaaaaaaaaaaaaaaaaaaaaaaaaaaaaaaaaaaaaaaaaaaaaaaaaaaaaaaaaaaaaaaaaaaaaaaaaaaaaaaaaaaaaaaaaaaaaaaaaaaaaa
aaaaaaaaaaaaaaaaaaaaaaaaaaaaaaaaaaaaaaaaaaaaaaaaaaaaaaaaaaaaaaaaaaaaaaaaaaaaaaaaaaaaaaaaaaaaaaaaaaaaaaaaaaaaaaaaaaaaaaaaaaaaaaaaaaaaaaaaaaaaaaaaaaaaaaaaaaaaaaaaaaaaaaaaaaaaaaaaaaaaaaaaaaaaaaaaaaaaaaaa
aaaaaaaaaaaaaaaaaaaaaaaaaaaaaaaaaaaaaaaaaaaaaaaaaaaaaaaaaaaaaaaaaaaaaaaaaaaaaaaaaaaaaaaaaaaaaaaaaaaaaaaaaaaaaaaaaaaaaaaaaaaaaaaaaaaaaaaaaaaaaaaaaaaaaaaaaaaaaaaaaaaaaaaaaaaaaaaaaaaaaaaaaaaaaaaaaaaaaaaa
aaaaaaaaaaaaaaaaaaaaaaaaaaaaaaaaaaaaaaaaaaaaaaaaaaaaaaaaaaaaaaaaaaaaaaaaaaaaaaaaaaaaaaaaaaaaaaaaaaaaaaaaaaaaaaaaaaaaaaaaaaaaaaaaaaaaaaaaaaaaaaaaaaaaaaaaaaaaaaaaaaaaaaaaaaaaaaaaaaaaaaaaaaaaaaaaaaaaaaaa
aaaaaaaaaaaaaaaaaaaaaaaaaaaaaaaaaaaaaaaaaaaaaaaaaaaaaaaaaaaaaaaaaaaaaaaaaaaaaaaaaaaaaaaaaaaaaaaaaaaaaaaaaaaaaaaaaaaaaaaaaaaaaaaaaaaaaaaaaaaaaaaaaaaaaaaaaaaaaaaaaaaaaaaaaaaaaaaaaaaaaaaaaaaaaaaaaaaaaaaa
aaaaaaaaaaaaaaaaaaaaaaaaaaaaaaaaaaaaaaaaaaaaaaaaaaaaaaaaaaaaaaaaaaaaaaaaaaaaaaaaaaaaaaaaaaaaaaaaaaaaaaaaaaaaaaaaaaaaaaaaaaaaaaaaaaaaaaaaaaaaaaaaaaaaaaaaaaaaaaaaaaaaaaaaaaaaaaaaaaaaaaaaaaaaaaaaaaaaaaaa
aaaaaaaaaaaaaaaaaaaaaaaaaaaaaaaaaaaaaaaaaaaaaaaaaaaaaaaaaaaaaaaaaaaaaaaaaaaaaaaaaaaaaaaaaaaaaaaaaaaaaaaaaaaaaaaaaaaaaaaaaaaaaaaaaaaaaaaaaaaaaaaaaaaaaaaaaaaaaaaaaaaaaaaaaaaaaaaaaaaaaaaaaaaaaaaaaaaaaaaa
aaaaaaaaaaaaaaaaaaaaaaaaaaaaaaaaaaaaaaaaaaaaaaaaaaaaaaaaaaaaaaaaaaaaaaaaaaaaaaaaaaaaaaaaaaaaaaaaaaaaaaaaaaaaaaaaaaaaaaaaaaaaaaaaaaaaaaaaaaaaaaaaaaaaaaaaaaaaaaaaaaaaaaaaaaaaaaaaaaaaaaaaaaaaaaaaaaaaaaaa
aaaaaaaaaaaaaaaaaaaaaaaaaaaaaaaaaaaaaaaaaaaaaaaaaaaaaaaaaaaaaaaaaaaaaaaaaaaaaaaaaaaaaaaaaaaaaaaaaaaaaaaaaaaaaaaaaaaaaaaaaaaaaaaaaaaaaaaaaaaaaaaaaaaaaaaaaaaaaaaaaaaaaaaaaaaaaaaaaaaaaaaaaaaaaaaaaaaaaaaa
aaaaaaaaaaaaaaaaaaaaaaaaaaaaaaaaaaaaaaaaaaaaaaaaaaaaaaaaaaaaaaaaaaaaaaaaaaaaaaaaaaaaaaaaaaaaaaaaaaaaaaaaaaaaaaaaaaaaaaaaaaaaaaaaaaaaaaaaaaaaaaaaaaaaaaaaaaaaaaaaaaaaaaaaaaaaaaaaaaaaaaaaaaaaaaaaaaaaaaaa
aaaaaaaaaaaaaaaaaaaaaaaaaaaaaaaaaaaaaaaaaaaaaaaaaaaaaaaaaaaaaaaaaaaaaaaaaaaaaaaaaaaaaaaaaaaaaaaaaaaaaaaaaaaaaaaaaaaaaaaaaaaaaaaaaaaaaaaaaaaaaaaaaaaaaaaaaaaaaaaaaaaaaaaaaaaaaaaaaaaaaaaaaaaaaaaaaaaaaaaa
aaaaaaaaaaaaaaaaaaaaaaaaaaaaaaaaaaaaaaaaaaaaaaaaaaaaaaaaaaaaaaaaaaaaaaaaaaaaaaaaaaaaaaaaaaaaaaaaaaaaaaaaaaaaaaaaaaaaaaaaaaaaaaaaaaaaaaaaaaaaaaaaaaaaaaaaaaaaaaaaaaaaaaaaaaaaaaaaaaaaaaaaaaaaaaaaaaaaaaaa
aaaaaaaaaaaaaaaaaaaaaaaaaaaaaaaaaaaaaaaaaaaaaaaaaaaaaaaaaaaaaaaaaaaaaaaaaaaaaaaaaaaaaaaaaaaaaaaaaaaaaaaaaaaaaaaaaaaaaaaaaaaaaaaaaaaaaaaaaaaaaaaaaaaaaaaaaaaaaaaaaaaaaaaaaaaaaaaaaaaaaaaaaaaaaaaaaaaaaaaa
aaaaaaaaaaaaaaaaaaaaaaaaaaabaaababaaaaaaaaaaaaaaaaaaaaaaaaaaaaaaaaaaaaaaaaaaaaaaaaaaaaaaaaaaaaaaaaaaaaaaaaaaaaaaaaaaaaaaaaaaaaaaaaaaaaaaaaaaaaaaaaaaaaaaaaaaaaaaaaaaaaaaaaaaaaaaaaaaaaaaaaaaaaaaaaaaaaaa
acaaaaabadabababababaeabadababababafagagagagadadadagagagagagagagagagagagadagahaaaiaaaaaaaaaaaaaaaaaaaaaaaaaaaaaaaaaaaaaaaaaaaaaaaaaaaaaaaaaaaaaaaaaaaaaaaaaaaaaaaaaaaaaaaaaaaaaaaaaaaaaaaaaaaaaaaaaaaaaa
acaaaaaaabajababadabababadabababababagagadagaaaaaaagagagagagadagagadagagagagakalamanaaaaaaaaaaaaaaaaaaaaaaaaaaaaaaaaaaaaaaaaaaaaaaaaaaaaaaaaaaaaaaaaaaaaaaaaaaaaaaaaaaaaaaaaaaaaaaaaaaaaaaaaaaaaaaaaaaaa
acaaaaaoapaqaqaaaaaqaaaaaaaqababarasafadadadagagagadadadadadadadagagagagadagalamamamaaaaaaaaaaaaaaaaaaaaaaaaaaaaaaaaaaaaaaaaaaaaaaaaaaaaaaaaaaaaaaaaaaaaaaaaaaaaaaaaaaaaaaaaaaaaaaaaaaaaaaaaaaaaaaaaaaaa
acaqaaatauaqauauauapaqaqaaaaaaavarawasaaaaaaafadakaxaxaiaxaxaxaxafagagagagakamamamamaaaaaaaaaaaaaaaaaaaaaaaaaaaaaaaaaaaaaaaaaaaaaaaaaaaaaaaaaaaaaaaaaaaaaaaaaaaaaaaaaaaaaaaaaaaaaaaaaaaaaaaaaaaaaaaaaaaa
acaaaaaaaqauayaaaaatauapaqazaAaBawaraCaaaaaaaaaaaaaaalamanaxaxaxaxafadadakamamamamamaaaaaaaaaaaaaaaaaaaaaaaaaaaaaaaaaaaaaaaaaaaaaaaaaaaaaaaaaaaaaaaaaaaaaaaaaaaaaaaaaaaaaaaaaaaaaaaaaaaaaaaaaaaaaaaaaaaa
acaaaqaaaaauaaaDaEaFatauapaGaHaaaBaCaaaaaaaaaaaaaaaaaIamaoanaxaxaxaxaxaxaIamamamamamaaaaaaaaaaaaaaaaaaaaaaaaaaaaaaaaaaaaaaaaaaaaaaaaaaaaaaaaaaaaaaaaaaaaaaaaaaaaaaaaaaaaaaaaaaaaaaaaaaaaaaaaaaaaaaaaaaaa
acaaaaaaaaauapaJaKaLaMauauauauapaMauapaaaqaMauauauauaIamamaNaOaxaxaxaxaxaIamamamamamaaaaaaaaaaaaaaaaaaaaaaaaaaaaaaaaaaaaaaaaaaaaaaaaaaaaaaaaaaaaaaaaaaaaaaaaaaaaaaaaaaaaaaaaaaaaaaaaaaaaaaaaaaaaaaaaaaaa
acaaaaaaaqatauauauauauauayaaaaatayaaatauauayaaaaaaaaaaaIamaPaOaxaxaxaxaxaIamamamamamaaaaaaaaaaaaaaaaaaaaaaaaaaaaaaaaaaaaaaaaaaaaaaaaaaaaaaaaaaaaaaaaaaaaaaaaaaaaaaaaaaaaaaaaaaaaaaaaaaaaaaaaaaaaaaaaaaaa
acaaaaaaaqaqauaaaaaqaaaqaqaaaaaaaaaaaaaaaaaaaaaaaaaaaxaxaIaQaxaxaxaxaxaxaIamamamamamaaaaaaaaaaaaaaaaaaaaaaaaaaaaaaaaaaaaaaaaaaaaaaaaaaaaaaaaaaaaaaaaaaaaaaaaaaaaaaaaaaaaaaaaaaaaaaaaaaaaaaaaaaaaaaaaaaaa
acaaaaaaaaaqaqaqaaaqaqaaaaaaaRadagagagagagahaaaxaxaxaxaxaxaxaxaxaxaxaxaxaIamamamamamaaaaaaaaaaaaaaaaaaaaaaaaaaaaaaaaaaaaaaaaaaaaaaaaaaaaaaaaaaaaaaaaaaaaaaaaaaaaaaaaaaaaaaaaaaaaaaaaaaaaaaaaaaaaaaaaaaaa
acaaaaaaaaaMauapaaaaaaaaaaaaagagagagagagadagaxaxaxaxaxaRahaxaxaxaxaxaxaxaxaIamamamamaaaaaaaaaaaaaaaaaaaaaaaaaaaaaaaaaaaaaaaaaaaaaaaaaaaaaaaaaaaaaaaaaaaaaaaaaaaaaaaaaaaaaaaaaaaaaaaaaaaaaaaaaaaaaaaaaaaa
aSaTaUaoauauayatauauauauapaqafadadadadagadakaxaxaxaxaxagagaxaxaxaxaxaxaxaxaaaIamamamaaaaaaaaaaaaaaaaaaaaaaaaaaaaaaaaaaaaaaaaaaaaaaaaaaaaaaaaaaaaaaaaaaaaaaaaaaaaaaaaaaaaaaaaaaaaaaaaaaaaaaaaaaaaaaaaaaaa
aSaSaSaTaaaaaaaaaaaaaaataoaaaaaaaaaaaqadaxaxaxaxasaxaxafakaxaxaxaxaxaxaxaxaaaIamamamaaaaaaaaaaaaaaaaaaaaaaaaaaaaaaaaaaaaaaaaaaaaaaaaaaaaaaaaaaaaaaaaaaaaaaaaaaaaaaaaaaaaaaaaaaaaaaaaaaaaaaaaaaaaaaaaaaaa
aSaSaSaSaVaVaVaVaVaVaVaVaVaVaVaVaTaaaaaxaxaxaxavawawasaxaxaxaxaxaxaxaiaxaxaaaIamamamaaaaaaaaaaaaaaaaaaaaaaaaaaaaaaaaaaaaaaaaaaaaaaaaaaaaaaaaaaaaaaaaaaaaaaaaaaaaaaaaaaaaaaaaaaaaaaaaaaaaaaaaaaaaaaaaaaaa
aSaSaSaSaSaSaSaSaSaSaSaSaSaSaSaSaSaVaTaxaxaxavawawawawaWawasaxaxalamamanaxaaaaaIamamaaaaaaaaaaaaaaaaaaaaaaaaaaaaaaaaaaaaaaaaaaaaaaaaaaaaaaaaaaaaaaaaaaaaaaaaaaaaaaaaaaaaaaaaaaaaaaaaaaaaaaaaaaaaaaaaaaaa
aaaaaaaaaaaaaaaaaaaaaaaaaaaaaaaaaaaaaaaaaaaaaaaaaaaaaaaaaaaaaaaaaaaaaaaaaaaaaaaaaaaaaaaaaaaaaaaaaaaaaaaaaaaaaaaaaaaaaaaaaaaaaaaaaaaaaaaaaaaaaaaaaaaaaaaaaaaaaaaaaaaaaaaaaaaaaaaaaaaaaaaaaaaaaaaaaaaaaaaa
aaaaaaaaaaaaaaaaaaaaaaaaaaaaaaaaaaaaaaaaaaaaaaaaaaaaaaaaaaaaaaaaaaaaaaaaaaaaaaaaaaaaaaaaaaaaaaaaaaaaaaaaaaaaaaaaaaaaaaaaaaaaaaaaaaaaaaaaaaaaaaaaaaaaaaaaaaaaaaaaaaaaaaaaaaaaaaaaaaaaaaaaaaaaaaaaaaaaaaaa
aaaaaaaaaaaaaaaaaaaaaaaaaaaaaaaaaaaaaaaaaaaaaaaaaaaaaaaaaaaaaaaaaaaaaaaaaaaaaaaaaaaaaaaaaaaaaaaaaaaaaaaaaaaaaaaaaaaaaaaaaaaaaaaaaaaaaaaaaaaaaaaaaaaaaaaaaaaaaaaaaaaaaaaaaaaaaaaaaaaaaaaaaaaaaaaaaaaaaaaa
aaaaaaaaaaaaaaaaaaaaaaaaaaaaaaaaaaaaaaaaaaaaaaaaaaaaaaaaaaaaaaaaaaaaaaaaaaaaaaaaaaaaaaaaaaaaaaaaaaaaaaaaaaaaaaaaaaaaaaaaaaaaaaaaaaaaaaaaaaaaaaaaaaaaaaaaaaaaaaaaaaaaaaaaaaaaaaaaaaaaaaaaaaaaaaaaaaaaaaaa
aaaaaaaaaaaaaaaaaaaaaaaaaaaaaaaaaaaaaaaaaaaaaaaaaaaaaaaaaaaaaaaaaaaaaaaaaaaaaaaaaaaaaaaaaaaaaaaaaaaaaaaaaaaaaaaaaaaaaaaaaaaaaaaaaaaaaaaaaaaaaaaaaaaaaaaaaaaaaaaaaaaaaaaaaaaaaaaaaaaaaaaaaaaaaaaaaaaaaaaa
aaaaaaaaaaaaaaaaaaaaaaaaaaaaaaaaaaaaaaaaaaaaaaaaaaaaaaaaaaaaaaaaaaaaaaaaaaaaaaaaaaaaaaaaaaaaaaaaaaaaaaaaaaaaaaaaaaaaaaaaaaaaaaaaaaaaaaaaaaaaaaaaaaaaaaaaaaaaaaaaaaaaaaaaaaaaaaaaaaaaaaaaaaaaaaaaaaaaaaaa
aaaaaaaaaaaaaaaaaaaaaaaaaaaaaaaaaaaaaaaaaaaaaaaaaaaaaaaaaaaaaaaaaaaaaaaaaaaaaaaaaaaaaaaaaaaaaaaaaaaaaaaaaaaaaaaaaaaaaaaaaaaaaaaaaaaaaaaaaaaaaaaaaaaaaaaaaaaaaaaaaaaaaaaaaaaaaaaaaaaaaaaaaaaaaaaaaaaaaaaa
aaaaaaaaaaaaaaaaaaaaaaaaaaaaaaaaaaaaaaaaaaaaaaaaaaaaaaaaaaaaaaaaaaaaaaaaaaaaaaaaaaaaaaaaaaaaaaaaaaaaaaaaaaaaaaaaaaaaaaaaaaaaaaaaaaaaaaaaaaaaaaaaaaaaaaaaaaaaaaaaaaaaaaaaaaaaaaaaaaaaaaaaaaaaaaaaaaaaaaaa
aaaaaaaaaaaaaaaaaaaaaaaaaaaaaaaaaaaaaaaaaaaaaaaaaaaaaaaaaaaaaaaaaaaaaaaaaaaaaaaaaaaaaaaaaaaaaaaaaaaaaaaaaaaaaaaaaaaaaaaaaaaaaaaaaaaaaaaaaaaaaaaaaaaaaaaaaaaaaaaaaaaaaaaaaaaaaaaaaaaaaaaaaaaaaaaaaaaaaaaa
aaaaaaaaaaaaaaaaaaaaaaaaaaaaaaaaaaaaaaaaaaaaaaaaaaaaaaaaaaaaaaaaaaaaaaaaaaaaaaaaaaaaaaaaaaaaaaaaaaaaaaaaaaaaaaaaaaaaaaaaaaaaaaaaaaaaaaaaaaaaaaaaaaaaaaaaaaaaaaaaaaaaaaaaaaaaaaaaaaaaaaaaaaaaaaaaaaaaaaaa
aaaaaaaaaaaaaaaaaaaaaaaaaaaaaaaaaaaaaaaaaaaaaaaaaaaaaaaaaaaaaaaaaaaaaaaaaaaaaaaaaaaaaaaaaaaaaaaaaaaaaaaaaaaaaaaaaaaaaaaaaaaaaaaaaaaaaaaaaaaaaaaaaaaaaaaaaaaaaaaaaaaaaaaaaaaaaaaaaaaaaaaaaaaaaaaaaaaaaaaa
aaaaaaaaaaaaaaaaaaaaaaaaaaaaaaaaaaaaaaaaaaaaaaaaaaaaaaaaaaaaaaaaaaaaaaaaaaaaaaaaaaaaaaaaaaaaaaaaaaaaaaaaaaaaaaaaaaaaaaaaaaaaaaaaaaaaaaaaaaaaaaaaaaaaaaaaaaaaaaaaaaaaaaaaaaaaaaaaaaaaaaaaaaaaaaaaaaaaaaaa
aaaaaaaaaaaaaaaaaaaaaaaaaaaaaaaaaaaaaaaaaaaaaaaaaaaaaaaaaaaaaaaaaaaaaaaaaaaaaaaaaaaaaaaaaaaaaaaaaaaaaaaaaaaaaaaaaaaaaaaaaaaaaaaaaaaaaaaaaaaaaaaaaaaaaaaaaaaaaaaaaaaaaaaaaaaaaaaaaaaaaaaaaaaaaaaaaaaaaaaa
aaaaaaaaaaaaaaaaaaaaaaaaaaaaaaaaaaaaaaaaaaaaaaaaaaaaaaaaaaaaaaaaaaaaaaaaaaaaaaaaaaaaaaaaaaaaaaaaaaaaaaaaaaaaaaaaaaaaaaaaaaaaaaaaaaaaaaaaaaaaaaaaaaaaaaaaaaaaaaaaaaaaaaaaaaaaaaaaaaaaaaaaaaaaaaaaaaaaaaaa
aaaaaaaaaaaaaaaaaaaaaaaaaaaaaaaaaaaaaaaaaaaaaaaaaaaaaaaaaaaaaaaaaaaaaaaaaaaaaaaaaaaaaaaaaaaaaaaaaaaaaaaaaaaaaaaaaaaaaaaaaaaaaaaaaaaaaaaaaaaaaaaaaaaaaaaaaaaaaaaaaaaaaaaaaaaaaaaaaaaaaaaaaaaaaaaaaaaaaaaa
aaaaaaaaaaaaaaaaaaaaaaaaaaaaaaaaaaaaaaaaaaaaaaaaaaaaaaaaaaaaaaaaaaaaaaaaaaaaaaaaaaaaaaaaaaaaaaaaaaaaaaaaaaaaaaaaaaaaaaaaaaaaaaaaaaaaaaaaaaaaaaaaaaaaaaaaaaaaaaaaaaaaaaaaaaaaaaaaaaaaaaaaaaaaaaaaaaaaaaaa
aaaaaaaaaaaaaaaaaaaaaaaaaaaaaaaaaaaaaaaaaaaaaaaaaaaaaaaaaaaaaaaaaaaaaaaaaaaaaaaaaaaaaaaaaaaaaaaaaaaaaaaaaaaaaaaaaaaaaaaaaaaaaaaaaaaaaaaaaaaaaaaaaaaaaaaaaaaaaaaaaaaaaaaaaaaaaaaaaaaaaaaaaaaaaaaaaaaaaaaa
aaaaaaaaaaaaaaaaaaaaaaaaaaaaaaaaaaaaaaaaaaaaaaaaaaaaaaaaaaaaaaaaaaaaaaaaaaaaaaaaaaaaaaaaaaaaaaaaaaaaaaaaaaaaaaaaaaaaaaaaaaaaaaaaaaaaaaaaaaaaaaaaaaaaaaaaaaaaaaaaaaaaaaaaaaaaaaaaaaaaaaaaaaaaaaaaaaaaaaaa
aaaaaaaaaaaaaaaaaaaaaaaaaaaaaaaaaaaaaaaaaaaaaaaaaaaaaaaaaaaaaaaaaaaaaaaaaaaaaaaaaaaaaaaaaaaaaaaaaaaaaaaaaaaaaaaaaaaaaaaaaaaaaaaaaaaaaaaaaaaaaaaaaaaaaaaaaaaaaaaaaaaaaaaaaaaaaaaaaaaaaaaaaaaaaaaaaaaaaaaa
aaaaaaaaaaaaaaaaaaaaaaaaaaaaaaaaaaaaaaaaaaaaaaaaaaaaaaaaaaaaaaaaaaaaaaaaaaaaaaaaaaaaaaaaaaaaaaaaaaaaaaaaaaaaaaaaaaaaaaaaaaaaaaaaaaaaaaaaaaaaaaaaaaaaaaaaaaaaaaaaaaaaaaaaaaaaaaaaaaaaaaaaaaaaaaaaaaaaaaaa
aaaaaaaaaaaaaaaaaaaaaaaaaaaaaaaaaaaaaaaaaaaaaaaaaaaaaaaaaaaaaaaaaaaaaaaaaaaaaaaaaaaaaaaaaaaaaaaaaaaaaaaaaaaaaaaaaaaaaaaaaaaaaaaaaaaaaaaaaaaaaaaaaaaaaaaaaaaaaaaaaaaaaaaaaaaaaaaaaaaaaaaaaaaaaaaaaaaaaaaa
aaaaaaaaaaaaaaaaaaaaaaaaaaaaaaaaaaaaaaaaaaaaaaaaaaaaaaaaaaaaaaaaaaaaaaaaaaaaaaaaaaaaaaaaaaaaaaaaaaaaaaaaaaaaaaaaaaaaaaaaaaaaaaaaaaaaaaaaaaaaaaaaaaaaaaaaaaaaaaaaaaaaaaaaaaaaaaaaaaaaaaaaaaaaaaaaaaaaaaaa
aaaaaaaaaaaaaaaaaaaaaaaaaaaaaaaaaaaaaaaaaaaaaaaaaaaaaaaaaaaaaaaaaaaaaaaaaaaaaaaaaaaaaaaaaaaaaaaaaaaaaaaaaaaaaaaaaaaaaaaaaaaaaaaaaaaaaaaaaaaaaaaaaaaaaaaaaaaaaaaaaaaaaaaaaaaaaaaaaaaaaaaaaaaaaaaaaaaaaaaa
aaaaaaaaaaaaaaaaaaaaaaaaaaaaaaaaaaaaaaaaaaaaaaaaaaaaaaaaaaaaaaaaaaaaaaaaaaaaaaaaaaaaaaaaaaaaaaaaaaaaaaaaaaaaaaaaaaaaaaaaaaaaaaaaaaaaaaaaaaaaaaaaaaaaaaaaaaaaaaaaaaaaaaaaaaaaaaaaaaaaaaaaaaaaaaaaaaaaaaaa
aaaaaaaaaaaaaaaaaaaaaaaaaaaaaaaaaaaaaaaaaaaaaaaaaaaaaaaaaaaaaaaaaaaaaaaaaaaaaaaaaaaaaaaaaaaaaaaaaaaaaaaaaaaaaaaaaaaaaaaaaaaaaaaaaaaaaaaaaaaaaaaaaaaaaaaaaaaaaaaaaaaaaaaaaaaaaaaaaaaaaaaaaaaaaaaaaaaaaaaa
aaaaaaaaaaaaaaaaaaaaaaaaaaaaaaaaaaaaaaaaaaaaaaaaaaaaaaaaaaaaaaaaaaaaaaaaaaaaaaaaaaaaaaaaaaaaaaaaaaaaaaaaaaaaaaaaaaaaaaaaaaaaaaaaaaaaaaaaaaaaaaaaaaaaaaaaaaaaaaaaaaaaaaaaaaaaaaaaaaaaaaaaaaaaaaaaaaaaaaaa
aaaaaaaaaaaaaaaaaaaaaaaaaaaaaaaaaaaaaaaaaaaaaaaaaaaaaaaaaaaaaaaaaaaaaaaaaaaaaaaaaaaaaaaaaaaaaaaaaaaaaaaaaaaaaaaaaaaaaaaaaaaaaaaaaaaaaaaaaaaaaaaaaaaaaaaaaaaaaaaaaaaaaaaaaaaaaaaaaaaaaaaaaaaaaaaaaaaaaaaa
aaaaaaaaaaaaaaaaaaaaaaaaaaaaaaaaaaaaaaaaaaaaaaaaaaaaaaaaaaaaaaaaaaaaaaaaaaaaaaaaaaaaaaaaaaaaaaaaaaaaaaaaaaaaaaaaaaaaaaaaaaaaaaaaaaaaaaaaaaaaaaaaaaaaaaaaaaaaaaaaaaaaaaaaaaaaaaaaaaaaaaaaaaaaaaaaaaaaaaaa
aaaaaaaaaaaaaaaaaaaaaaaaaaaaaaaaaaaaaaaaaaaaaaaaaaaaaaaaaaaaaaaaaaaaaaaaaaaaaaaaaaaaaaaaaaaaaaaaaaaaaaaaaaaaaaaaaaaaaaaaaaaaaaaaaaaaaaaaaaaaaaaaaaaaaaaaaaaaaaaaaaaaaaaaaaaaaaaaaaaaaaaaaaaaaaaaaaaaaaaa
aaaaaaaaaaaaaaaaaaaaaaaaaaaaaaaaaaaaaaaaaaaaaaaaaaaaaaaaaaaaaaaaaaaaaaaaaaaaaaaaaaaaaaaaaaaaaaaaaaaaaaaaaaaaaaaaaaaaaaaaaaaaaaaaaaaaaaaaaaaaaaaaaaaaaaaaaaaaaaaaaaaaaaaaaaaaaaaaaaaaaaaaaaaaaaaaaaaaaaaa
aaaaaaaaaaaaaaaaaaaaaaaaaaaaaaaaaaaaaaaaaaaaaaaaaaaaaaaaaaaaaaaaaaaaaaaaaaaaaaaaaaaaaaaaaaaaaaaaaaaaaaaaaaaaaaaaaaaaaaaaaaaaaaaaaaaaaaaaaaaaaaaaaaaaaaaaaaaaaaaaaaaaaaaaaaaaaaaaaaaaaaaaaaaaaaaaaaaaaaaa
abababaxaxauauauauauauauauauauauauauauauauauauauauauauauauaxaxaxaxaIaIamaPaOaXaVaVaVaVaTaxaxaxaxaxaxaeavawawawawawawawawaaaaaaaaaaaaaaaaaaaaaaaaaaaaaaaaaaaaaaaaaaaaaaaaaaaaaaaaaaaaaaaaaaaaaaaaaaaaaaaa
ababaxaxaxauauauauauauauauauauauaoauauauauauauauauauauauayaxaxaxaxaYaIamaPaOaZaobabaaoacaxaxaxaxaxaxaxawawarawawawawarawaaaaaaaaaaaaaaaaaaaaaaaaaaaaaaaaaaaaaaaaaaaaaaaaaaaaaaaaaaaaaaaaaaaaaaaaaaaaaaaa
abababaxaxauauauauauauauauauauaobaaoauauauauauauauauauauaxaxaxaxaxaxaYaNaQaxaZbbazaAbbacaxaxaxaxaxaxavawawawawawawawawawaaaaaaaaaaaaaaaaaaaaaaaaaaaaaaaaaaaaaaaaaaaaaaaaaaaaaaaaaaaaaaaaaaaaaaaaaaaaaaaa
abababaxaMauauauauauauauauauaobbaebbaoauauauauauauauauauaxaxaxaxaxaxaxaxaxaxaZbbaGaHbbacaxaxaeaxaxaxawawawawawawawawawawaaaaaaaaaaaaaaaaaaaaaaaaaaaaaaaaaaaaaaaaaaaaaaaaaaaaaaaaaaaaaaaaaaaaaaaaaaaaaaaa
ababaxaxauauauauauauauauauauauaobaaoauauauauauauauauauauaxaxaxaxaxaxaxaxaxaxaZaobabaaoacaxaxaxaxaxaxawawawawarawawawawawaaaaaaaaaaaaaaaaaaaaaaaaaaaaaaaaaaaaaaaaaaaaaaaaaaaaaaaaaaaaaaaaaaaaaaaaaaaaaaaa
ababaxaxatauauauauauauauauauauauaoauauauauauauauauauauauaxaxaxaxaxaxaxaxaxaxbcbdbdbdbdbeaxaxaxaxaxaxawawawawawawawawawawaaaaaaaaaaaaaaaaaaaaaaaaaaaaaaaaaaaaaaaaaaaaaaaaaaaaaaaaaaaaaaaaaaaaaaaaaaaaaaaa
abagahaxaxatauauauauauauauauauauauauauauauauauauauauauayaxaxaxaxaxaxaxaxaxaxaxaxaxaxaRagagadahaxaxaxaBawawarawawawawawawaaaaaaaaaaaaaaaaaaaaaaaaaaaaaaaaaaaaaaaaaaaaaaaaaaaaaaaaaaaaaaaaaaaaaaaaaaaaaaaa
abagagaxaxaxatauauauauauauauauauauauauauauauauauauauauaxaxaxaxaxaxaxaxaxaxaxaxaxaxaRagagagaxagagahaxaxaBawawawawawawawawaaaaaaaaaaaaaaaaaaaaaaaaaaaaaaaaaaaaaaaaaaaaaaaaaaaaaaaaaaaaaaaaaaaaaaaaaaaaaaaa
abagadaxaxaxaxaxaxaxaxaxatauauauauauauauauauauauauauauaxaxaxaxaxaxaxaxaxaeaxaxaxaRagadadadadadadakaxaxaxaxaBawawawawarawaaaaaaaaaaaaaaaaaaaaaaaaaaaaaaaaaaaaaaaaaaaaaaaaaaaaaaaaaaaaaaaaaaaaaaaaaaaaaaaa
adadaxaxaxaxaxaxaxaxaxaxaxaxaxaxaxaxaxaxatauauauauauayaxaxaxaxaxaxaxaxaxaxaxaRagagakajaxaxaxaxaxaxaxaxaxaxaxaBawawawawawaaaaaaaaaaaaaaaaaaaaaaaaaaaaaaaaaaaaaaaaaaaaaaaaaaaaaaaaaaaaaaaaaaaaaaaaaaaaaaaa
axaxaxajaxaxaxaxaxaxaxaxaxaxaxaxaxaxaxaxaxaxaxatauayaxaxaxaxaxaxaxajaxaxaxaRagagakaxaxaxaxaxaxaxaxaxaxaxaxaxaxaBawawawawaaaaaaaaaaaaaaaaaaaaaaaaaaaaaaaaaaaaaaaaaaaaaaaaaaaaaaaaaaaaaaaaaaaaaaaaaaaaaaaa
axaxaxaxaxaxaxaxaxaxaxaeaxaxaxaxaxaxaxaxaxaxaxaxaxaxaxaxaxaxaxaxaiaxaxaxaxafadakaeaxaxaxaxaxaxaxaxaxaxaxaxaxaxaxaBawawawaaaaaaaaaaaaaaaaaaaaaaaaaaaaaaaaaaaaaaaaaaaaaaaaaaaaaaaaaaaaaaaaaaaaaaaaaaaaaaaa
adaxaxaxadaxaxabaxaxajaxaxabaxaxaxaxaxababaxaxaxaxaxaxaxaxaxaxalaIanaxaxaxajaxaxaxaxaxaiaxaxaxaxaxaxaxaxaxaxaxaxaxaxaxaxaaaaaaaaaaaaaaaaaaaaaaaaaaaaaaaaaaaaaaaaaaaaaaaaaaaaaaaaaaaaaaaaaaaaaaaaaaaaaaaa
aTagaxaxaxaxaxababaxaxaxaxaxaxaxaxaxaxabaxaxababababaxaxaxaxaxaIbfbganaxaxaxaxaxaxaxalbfanaxaxaxaxaxaxaxaxaxaxaxaxaxaxaxaaaaaaaaaaaaaaaaaaaaaaaaaaaaaaaaaaaaaaaaaaaaaaaaaaaaaaaaaaaaaaaaaaaaaaaaaaaaaaaa
aSagaxaxaxaxababaxaxaxabaxabaxaxaxababaxababaxaxaxabababaxaxaxaYaIamaNaOaxaxaxaxaxalaIbfaPaxaxaxaxaxaxaxaxaxaxaxaxaxaxaxaaaaaaaaaaaaaaaaaaaaaaaaaaaaaaaaaaaaaaaaaaaaaaaaaaaaaaaaaaaaaaaaaaaaaaaaaaaaaaaa
aSadaxaxaxabaoabaxaRahaxaxabababababaxababaxaxaxaxaxababaxaxaxaxaYaIaPaOaxaxaxaxaxaIbfbfaNaxaxaxaxaxaxaxaxaxaxaxaxaxaxaxaaaaaaaaaaaaaaaaaaaaaaaaaaaaaaaaaaaaaaaaaaaaaaaaaaaaaaaaaaaaaaaaaaaaaaaaaaaaaaaa
aSagaxaxababababaxadadaxaxaxaxaxaxaxaxaxaxaxaxaxaxaxaxaxaxaxaxaxaxaYaQaxaxaxaxaxaxaYaIaNaQaxaxaxaxaxaxaxaxaxaxaxaxaxaxaxaaaaaaaaaaaaaaaaaaaaaaaaaaaaaaaaaaaaaaaaaaaaaaaaaaaaaaaaaaaaaaaaaaaaaaaaaaaaaaaa
acadahaxababababaxaxaxaxaxaxaxaxaxaxaxaxaxaxaxajaxaxaxaxaxaxaxaxaxaxaxaxaxaxaxaxaxaxaYaQaxaxaxaxaxaxaxaxaxaxaxaxaxaxaxaxaaaaaaaaaaaaaaaaaaaaaaaaaaaaaaaaaaaaaaaaaaaaaaaaaaaaaaaaaaaaaaaaaaaaaaaaaaaaaaaa
aSaTadaxabababababaxaxaxaxaxaeaxaxaxaxaxaxaxaxaxaxaxaxaxaxaxaxaxaxaxaxaxaxaxaxaxaxaxaxaxaxaxaxaxaxaxaxaxaxaxaxaxaxaxaxaxaaaaaaaaaaaaaaaaaaaaaaaaaaaaaaaaaaaaaaaaaaaaaaaaaaaaaaaaaaaaaaaaaaaaaaaaaaaaaaaa
aSacaxabaxabababaxaxaxaxaxaxaxaxaxaxaxaxaxaxaxaxaxaxaxaxaxaxaxaxaxaxaxaxaxaaaxaxaxaxaxaxaxaxaxaxaxaxaxaxaxaxaxaxaxaxaxaxaaaaaaaaaaaaaaaaaaaaaaaaaaaaaaaaaaaaaaaaaaaaaaaaaaaaaaaaaaaaaaaaaaaaaaaaaaaaaaaa
aSaSaRadadagagagagahaxaiaxaxaxaxaxaxaxaxaxaxaxaxaxaxaxaxaxaxaxaxavawawaWaWasaxaxaxaxaxaxaxaxaxaxaxaxaxaxaxaxaxaxaxaxaxaxaaaaaaaaaaaaaaaaaaaaaaaaaaaaaaaaaaaaaaaaaaaaaaaaaaaaaaaaaaaaaaaaaaaaaaaaaaaaaaaa
acadagbhbhadabababadalaIanaxaxaxaxaxaxaxaxaxaxaxaxaxaxaxavawawawawawawawawawawawasaxavawawawawasaxaxaxaxaxaxaxaxaxaxaxaxaaaaaaaaaaaaaaaaaaaaaaaaaaaaaaaaaaaaaaaaaaaaaaaaaaaaaaaaaaaaaaaaaaaaaaaaaaaaaaaa
aSbiadagbjababadababalbfbganaxaxaxaxaxaxaxaxaxaxaxaxaxavawawawawawawawawawawawawawaWawawawawawawasaxaxaxaxaxaxaxaxaxaxaxaaaaaaaaaaaaaaaaaaaaaaaaaaaaaaaaaaaaaaaaaaaaaaaaaaaaaaaaaaaaaaaaaaaaaaaaaaaaaaaa
bkbbbladababbmabababaIamambnboaxaxaxaxaxaxaxaxaxaxaxavawawawawarawawawawawawawawawarawawawawawarawawawawasaxaxaxaxaxaxaxaaaaaaaaaaaaaaaaaaaaaaaaaaaaaaaaaaaaaaaaaaaaaaaaaaaaaaaaaaaaaaaaaaaaaaaaaaaaaaaa
abbpbqaTaRahababagahaIambrbsaPboaxaxaxaxaxaxaxaxaxaxawawawawawawawawawawawawawawawawawawawawawawawawawawawasaxaxaxaxaxaxaaaaaaaaaaaaaaaaaaaaaaaaaaaaaaaaaaaaaaaaaaaaaaaaaaaaaaaaaaaaaaaaaaaaaaaaaaaaaaaa
ababagabagagagadabagaIamambraPaPaOaxaRagagahaxaxaxaxaBawawawawawawawawawawawawaCaaaaaaaaaaaBawawawawawawawawaxaxaxaxaxaxaaaaaaaaaaaaaaaaaaaaaaaaaaaaaaaaaaaaaaaaaaaaaaaaaaaaaaaaaaaaaaaaaaaaaaaaaaaaaaaa
agagagbtadabadabadagaIamamambuaPaOaRagadadagahaxaxaxaxaBawawawawawawarawawawaCaaaXaVaVaVaVaTaBawawawawarawawaxaxaxaxaxaxaaaaaaaaaaaaaaaaaaaaaaaaaaaaaaaaaaaaaaaaaaaaaaaaaaaaaaaaaaaaaaaaaaaaaaaaaaaaaaaa
agagagaZbqadaDaEaFadaIamamamaNaPaOafagaxaxadagahaxaxaxavawarawawawawawawawaCaaaaaZaobabaaoacaaawawawawawawawasaxaxaxaxaxaaaaaaaaaaaaaaaaaaaaaaaaaaaaaaaaaaaaaaaaaaaaaaaaaaaaaaaaaaaaaaaaaaaaaaaaaaaaaaaa
blagadbvadbjaJaKaLaeaYaIamambnaPaOaxafahaxaRagagahaxaxbwawawawawawawawawaCaaaeaaaZbbazaAbbacaaawawarawawawawaxaxaxaxaxaxaaaaaaaaaaaaaaaaaaaaaaaaaaaaaaaaaaaaaaaaaaaaaaaaaaaaaaaaaaaaaaaaaaaaaaaaaaaaaaaa
adadbladbxaSbhbhbhblajaIamambsaPbyaxaxagaRagagagakaxaBawawawawawawawawawasajaaaeaZbbaGaHbbacaaawawawawawawawaxaxaxaxaxaxaaaaaaaaaaaaaaaaaaaaaaaaaaaaaaaaaaaaaaaaaaaaaaaaaaaaaaaaaaaaaaaaaaaaaaaaaaaaaaaa
bcbdbqbzaSaRagagagagahaIamamamaPaOaeaxagagagagagaxaxaxawawawawawawawawawawasaaaaaZaobabaaoacaaawawawawawawawaxaxaxaxaxaxaaaaaaaaaaaaaaaaaaaaaaaaaaaaaaaaaaaaaaaaaaaaaaaaaaaaaaaaaaaaaaaaaaaaaaaaaaaaaaaa
aRahakbxaSadagagagagagaIamamambsboaxaeagagagagakaxaxaxaBawawawawawawarawawawasaabcbdbdbdbdbeavawawawawawawawasaxaxaxaxaxaaaaaaaaaaaaaaaaaaaaaaaaaaaaaaaaaaaaaaaaaaaaaaaaaaaaaaaaaaaaaaaaaaaaaaaaaaaaaaaa
agagbxaSadbiadagadadagaYaIamamamaPaOaRagagagakaxaxaxaxaxaBawawawawawawawawawawasaaaaaaaaaaavawawawawawawawawawaxaxaxaxaxaaaaaaaaaaaaaaaaaaaaaaaaaaaaaaaaaaaaaaaaaaaaaaaaaaaaaaaaaaaaaaaaaaaaaaaaaaaaaaaa
agagbAaSaSbbbladbxbBagahaYaIamamaPaOagagagakaxaxaxaxaxaxaxaBawawawawawawawawawawawawawawawawawawawawawawawawaCaxaxaxaxaxaaaaaaaaaaaaaaaaaaaaaaaaaaaaaaaaaaaaaaaaaaaaaaaaaaaaaaaaaaaaaaaaaaaaaaaaaaaaaaaa
agagbAaRahbpbqblbtbCagagaaaYaIamaPaOagadakaxaxaxaxaxaxaxaxaxbwarawawawawarawawawawawawawawawawawawawawawawawaxaxaxaxaxaxaaaaaaaaaaaaaaaaaaaaaaaaaaaaaaaaaaaaaaaaaaaaaaaaaaaaaaaaaaaaaaaaaaaaaaaaaaaaaaaa
agagbAafagagbDbqacaRadagahaaaYaIaQaRagaxaxaxaxaxaxaxaxaxaxavawawawawawawawawawawawawawawawawawawarawawawawawaxaxaxaxaxaxaaaaaaaaaaaaaaaaaaaaaaaaaaaaaaaaaaaaaaaaaaaaaaaaaaaaaaaaaaaaaaaaaaaaaaaaaaaaaaaa
agagbcaTagagakbAacadacagagagagagagagakaxaxaxaxaxaxaxaxaxaxawawawawawawawawawawawarawawawawawawawawawawawawawasaxaxaxaxaxaaaaaaaaaaaaaaaaaaaaaaaaaaaaaaaaaaaaaaaaaaaaaaaaaaaaaaaaaaaaaaaaaaaaaaaaaaaaaaaa
agakbxbjagbEaXbebcaTafadagagagagadakaxaxaxaxaxaxaxaxaxaxavawawawawarawawawawarawawawawawawawawawawawawawarawawaxaxaxaxaxaaaaaaaaaaaaaaaaaaaaaaaaaaaaaaaaaaaaaaaaaaaaaaaaaaaaaaaaaaaaaaaaaaaaaaaaaaaaaaaa
afbxbjbBbFbabGbHbFbababGafadadbEaxaxaxaxaxaxaxaxaxaxaxaxawawawawawawawawawawawawawawawawawawawawawawawawawawawaxaxaxaxaxaaaaaaaaaaaaaaaaaaaaaaaaaaaaaaaaaaaaaaaaaaaaaaaaaaaaaaaaaaaaaaaaaaaaaaaaaaaaaaaa
"}
